WBRWBRWBRWBR
B...........
....CCCCC..R
B..........B
WRWRWRWRWRWR